我 是 做 淘宝客 推广 的	我 是 做 淘宝 碦 推广 的
聚划算 活动 ， 299-20	活动 ， 228-20
购物 津贴 能用 吗 ， 300-30 , 满 300 减 30	购物 津贴 能用 吗 ， 400-50 , 满 400 减 50
, 价钱 能 便宜点 吗	有 优惠 吗
送 小熊 或 浴袍 规则 （ 限量 ）	0点 抢 浴袍 或 小熊 规则
每 款 佛跳墙 够 几 人 食用	哪种 佛跳墙 质量 最好	够 几 人 食用
需要 填写 李佳琪 吗	备注 李嘉琪	报备 报备 ！ 李佳琦 粉丝 ！ 谢谢	需要 备注 李嘉琪 么	李佳琦 推荐 别 忘 赠品	佳 琦 说 找 客服 就 行	你好 ， 请问 要 填 李佳琦 吗
冰箱 怎么 两侧 顶上 这么 烫 热	冰箱 顶上 怎么 这么 烫 这么 热	冰箱 两侧 怎么 发 烫
家人 已经 通过 其他 渠道 购买 了 所需 家具	我 再 看看 ， 需要 了 联系 你	不 需要 了 ， 我 已经 买了
推拉 的 地方 会不会 容易 生锈	轨道 会不会 生锈
冰箱 怎么 工作 一 会儿 就 停	冰箱 怎么 一 会儿 就 启动	冰箱 怎么 一直 启动
推荐 一款 给 宝宝 煮粥 的 锅	适合 给 宝宝 煮粥 的 有 哪些 锅
定制 锦旗	锦旗 可以 定制 吗
牛仔 的 可以 用 吗	棉质 的 可以 用 吗	可以 熨 尼龙 的 吗	冬天 的 衣服 可以 用 吗
桌子 怎么 安装	有 桌子 的 安装 视频 吗	电 竞 桌 安装 视频	桌子 安装 视频	座椅 收到 了 ， 怎么 按 啊	桌子 的 安装 视频 有 吗
水泵 什么 用	水泵 是 干什么 的	泵 是 什么 作用
你家 有 试用装 吗	a2 奶粉 有 小 的 适用 装 吗	你好 ， 有 试用装 吗	小 份量 的 奶粉 ， 新生儿 试用 的	有 小 罐 的 吗	有 小 罐 的 试用装 吗	一段 的 有 小包装 的 吗	咱们 有没有 试用装 啊	有 试用装 吗
怎么 安装	是不是 要 经过 编程 才 好 使用	使用 技巧
水壶 打烂 了 ， 可以 只 买 水壶 吗	有 单独 卖 壶 的 吗	壶 身 单卖 吗	可以 重新 配 一个 水壶 吗	玻璃壶 坏了 ， 可以 单买 吗	能 单买 个 壶 吗	亲 ， 玻璃壶 有 单独 卖 的 吗
推荐 尺码	这款 说明 里 的 尺码 是 空 表
这个 需要 滤纸 吗	咖啡机 需要 滤纸 吗
好 安装 吗	安装 麻烦 不
赠品 我 要 一个 补水 一个 清洁 帮 我 修改 一下 谢谢 亲	你好 赠送 的 颜色 可以 自己 选 吗
包装 及 发货 时效 说明	怎么 包装 有 冰袋 吗
煤气炉 有 声音 吗	煤气炉 是 用 电池 吗	有 煤气炉 吗
预售 订单 在哪里	现在 还 可以 支付 吗	不关 支付宝 的 事 是 你们 没有 付钱 这个 选项	是 预付金 退款	二 阶段 在 哪 付	后面 的 钱 怎么 付款	帮 我 看 一下 是 记得 什么 颜色	时间 过 了 就 不能 了 吗	点击 后 怎么 就 到 店铺 首页 了	我 没有 可以 点 进去 的 支付 页面	今天 都 23号 了 ， 到底 什么 时候 开始 结账 啊	时间 显示 ， 是 到 23号 的 呢	这个 预售 是 怎么 付款	会不会 是 订单 的 缘故 ， 我 另外 的 订单 是 可以 付钱 的	为什么 总是 显示 第二 阶段 还 未 开始 啊 ， 马上 都 过 了 呀	不会 交尾 款	我 支付 定金	你 那边 可以 看到 我 的 预付 订单 吗	请问 下 预售 的 ， 我 咋 还 不能 给钱 呢	怎么 给 尾数 你们	那 就 必须 得 22号 当天 给 才 行 是 吧	而且 你们 直到 现在 都 还 在 开放 预售	为什么 我 这个 支付 不 起	我 以为 是 2月 22	现在 付 不了 尾款 是 吧	什么 时候 能 把 预售 的 钱 交 了 呢	这 不是 坑人 嘛 ， 我 交 了 30 定金 又 不让 我 买	我 没有 超过 支付 时间 吧	之前 还没 卖完 的 时候 我 就 预定 啦 。	那 我 定金 付 了 ， 是 怎么 说	怎么 付 第二 阶段 的 款	点 开 就是 页面 没 支付 的 啊 . . .	我 购买 的 预售 商品	后面 的 钱 怎么 支付	按 这个 操作 是 这个 界面 ， 完 后 我 应该 怎么弄	今天 不是 开始 制度 尾款 吗 怎么 订单 上 显示 未 开始 呢	点 了 然后 就 直接 进入 你 的 店铺 了	尾款 怎么 付	那 二次 付款 什么 时候	我 找到 的 它 怎么 没有 付 全款	我 以为 是 要 22号 24点 以后 支付	时间 都超 了 ， 为啥 预售 还 能 付定金 ， 欺骗 消费者 嘛	今天 怎么 不能 结尾 款 啊	我 这个 订单 没了	是 22号 到 23号 付款 就 行 吗	我 点 进去 显示 店铺 的 页面	未 开始 啊	我 怎么 付款 呢	预售 为什么 还没有 开启	亲 ， 第二 阶段 为什么 还没 开始	怎么 付 尾款 啊	请问 怎么 交尾 金	预付款 多少天 补 尾 金	怎么 3月 才能 买	点 进去 就是 进 店里 页面 了 ， 没有 弹出 支付 密码	怎么 支付 啊	在哪里 支付	好久 给 后面 的 钱	点 开 就是 页面 没 支付 的 啊	你 这个 定金 交完 后 ， 其他 的 怎么 给	到底 是 哪天 付 啊	想 支付 也 选中 不了
温度 高会 不会 变热 变形	机器 使用 会 变形 吗	到时候 温度 高 了 会不会 容 化 了	加热器 工作 塑料 衣架 可以 放 里面 会 烧焦 吗
长时间 考研 看 视频 用	主要 是 网上 学习 课程 用 的	我 想要 款 耳机 学习
这个 需要 滤纸 吗	咖啡机 需要 滤纸 吗
手摇 下来 一边 只能 降下来 一边	这个 换 杆 升降 要 怎么 换 呢	为什么 只 摇 下来 一边	这 两根 是否 可以 同时 升降 的	一个 把手 摇 怎么 控制 两根 绳 绳 降 呢	这 两个 衣架 里面 的 是 怎么 升降 的 呢	这个 那个 转 的 怎么 控制 两个	手柄 控制 三个 杆 吗	怎么 切换 轨道 呢	怎么 摇下 另一边 啊	我 想 问 怎么 放下 来 另外 一根	怎么 转换 两杆	手摇器 怎么 使用	一次 摇 一根 还是 两根	这个 双杆 到时候 可以 上下 分开 吗	晾衣架 怎么 就 一边 可以 升降	摇手柄 怎么 切换	怎么 换 杆 摇	手摇器 怎么 换挡	请问 这 两种 怎么 转换 呢	怎么 摇 第 二根 杆子 下来
没有 优惠券 了	310元 优惠包	优惠券 失效 了	领 优惠券	在哪里 领 300 大额 购物券	卷领 完 了	还有 优惠券 吗	100元 优惠券	80元 优惠券	优惠券 领 不了	200元 优惠 礼包	价格 不对	优惠 礼包	怎么 领 优惠券	领 300 的 优惠券	怎么 秒 券	怎么 没有 优惠券
请问 哪 款 发光 比较 亮	男士 的 推荐 一款	哪个 图案 配 我 手机	哦 好看 吗	选 一下 图案	那个 图案 的 好 呢	我 想 问下 ， 哪 款 比较 畅销 啊	哪 一款 买 的 人 多 一些	哪个 图案 好看	实物 哪个 好看	手机壳 有没有 推荐	我 要 买手 机壳	亲 这 三个 实物 发光 那个 好看	什么 颜色 美	我 看 一下 那个 外壳 图片	苹果xs 手机壳 有没有 推荐	这个 手机壳 哪 款 卖 的 最 火	拍 哪个 图案 好	我 的 手机 是 黑色 的 适合 用 那个 手机壳 了	亲 这 三个 实物 发光 那个 好看	推荐 一下 图案 哦	xr 没有 标致 发光 的 吗	三只 猪 的 没 看到 啊	帮 我 选 一款 图案 哦	就 只有 一款 么 ， 第 一个 的 那个 图片	是 黑色 的 壳子 嘛	推荐 一款 好看 的 手机壳 嘛	哪个 图案 多 人 买 啊	这个 是 发光 字体 吗	手机壳 背板 就 这 几种 嘛	哪个 卖 的 好
这个 重量 是 多少	3 * 4 格 单支架 大约 多重	这个 总的 重量 有 多重 呀	架子 有 多重 呢	哪个 最轻	这个 画架 大概 有 多重 啊	一 个人 能 拿 得 动 吗	那个 80@180 的 加重 铁架子 有 多重	实际 重量 是 多少	重量 多少	这个 的 重量	你们 这个 实际 是 多重
4件 怎么 算	这个 1件 怎么 算	99 3件 ， 买 6件 减 两个 99 吗	不能 按照 每件 33元 吗
冷冻油 是 什么	冷冻油 有 什么 用	什么 是 冷冻油
60l 的 图片 发给 我 看 一 下好 吗	60l 单门 的 多大	60 单门 的 尺寸 多大	60 的 给 我 看 一下
手腕 周长	l码 和 m码 有 什么 区别 吗	m码 和 l码 的 区别	l码 和 m码 的 区别 是 什么
需要 做 活动 的 吗 我们 有 专业 的 团队	店铺 有 考虑 出售 没	请问 有 店铺 出售 的 意向 吗
能 少点 吗	能 再 优惠点 没	给 最低价	给 个 低价	亲 价格 可以 再 优惠点 吗
怎么 打 6折	第 2件 半价	6折 专区	半价 怎么 拍
侧面 防撞 ， 按 下去 会弹 出来 吗	侧面 的 防撞 环 平常 是 应该 按 下去 还是 弹出来 啊
产 口 是 什么 口感 好喝 吗	是 什么 口味 的	饮料 是 甜 的 吗
怎么 用 的	怎么 使用
抽 150元 劵 是 什么 意思	这个 抽 150 是 什么 意思	这个 抽 200 是 什么 意思	抽 200元 劵 是 什么 意思	到 那里 抽奖 、 抽 券
能 包邮 吗 / 多少 包邮 / 请问 有 运费 吗 / 有 运费	为什么 不包邮 的
可以 批发 么	批发 什么 价格	亲 你家 批发 是 怎样 的	长期 拿货 可以 优惠 吗	可以 在 您 家 拿货 吗	拿 多少 可以 优惠 呢	可以 便宜点 吗	买多 可以 打折 么	可以 代理 么	拿 的 多 有 优惠 吗	批发 送 东西 吗	你家 批发 吗	赠送 运费险 吗	你们 批发 是 怎么 算 的	批发 的 有 活动 的 吗	有 折扣 吗	怎么 批发	我 买 的 多 折扣 多少	批发 几 折	多少 才能 批发	我 要 的 多 可以 给 我 打的 最低 折扣 是 多少	你们 家 货 怎么 拿	批发 有 什么 优惠	支持 批发 吗	亲 批发 还有 礼物 送 吗	多少件 起 批 ， 价格 怎么 算
多久 有 效果	这个 能用 几个 月	受损 发 质 需要 几瓶	枯草 一样 的 头发 变得 柔顺 的话 是不是 要 有 一个 疗程 什么 的	一天 两次 能用 多久	这个 每天 擦 能用 多久 呢	不 连续 用 还 会 有 效果 吗	不 不 我 的 意思 是 大约 能用 到 年底 吗	能用 一个 月 左右 嘛
你好 两款 石斛兰 面膜 有 什么 不一样 吗	石斛兰 这 两个 有 什么 不同 呢	亲 55 的 浅蓝色 和 260 的 深蓝色 石斛兰 有 区别 吗	石斛兰 两款 面膜	这 两个 有 什么 不同 呢
到手 价 109	前 300件 109	怎么 买 淘 抢购 109 啊
眼线 可以 选 棕色 吗	你好 这个 眼线胶 笔 是 只有 0.1g 吗
118 的 能不能 用	k199 怎么 用
你好 请问 有 单独 的 刀头 吗	请问 有 单独 的 刀头 吗
红 光 模式 可以 按着 皮肤 还是 要 一定 距离	rf led 是 不能 贴近 皮肤 吗	红 光 模式 是 照 眼睛 的 吗	11 红 光 模式 可以 贴 脸 吗	rfled 是 全部 都 是 距离 5cm 吗	led 这 两个 模式 是 贴 脸 做 吗	请问 10t 的 rf led 红灯 模式 可以 直接 贴 脸 吗	红 光 射频 美容仪 是 直接 贴 在 脸上 么	led 红灯 能用 在 脸上 吗 除了 眼睛	亲 led 模式 是 贴 脸 用 还是 隔开 几 厘米 啊	你好 ， 我 想 问 一下 那个 红外 模式 是 不能 贴着 脸 吗	红 光 模式 需要 离 皮肤 几 公分 吗	请问 这个 红 光要 与 皮肤 给 开 距离 么	你好 rf led 是 贴面 使用 的 吗	那红光 的 那个 要 不要 贴到 脸上
材质 硬 吗	1盒 几片 的	这个 吃 粉 吗
到时候 你 不给 我 退 差价	会不会 不退 差价	差价 一定 会 退 的 吧
新 原料 的 和 卡通 图案 的 有 什么 区别	不 都 是 60 片 吗	这 两款 有 什么 区别 么	和 40 送 20 那个 有 什么 区别	上面 两个 链接 有 什么 区别	这 两款 有 什么 不一样 的	有 什么 不一样 吗
买 的 多 ， 是 活动价 后 再 打折 吗	这件 99 还 享受 3件 8折 吗	3件 8折 是 指 标价 后 的 8折 么	付 尾款 时 打折 吗	是 尾款 享受 8折 吗	上面 还有 付 尾款 是 3件 8折 优惠 ， 是 在 79 的 基础 上 再 八	3件 8折 ， 是 99 打 8折 还是 139 打 8折 呢	预售 3件 8折 是 付 尾款 的 时候 还 打折 吗	3件 8折 ， 是 在 79 的 基础 上 再 打 8折 吗	是 原价 的 基础 上三 件 8折 还是 标价 后 8折	是 付 尾款 时 打折 吗	3件 8折 是 全款 8折 吗	8折 是 付 尾款 的 时候 吗	3件 8折 ， 是 付 尾款 的 时候 打折 吗	3件 享受 原价 的 8折 吗	到 时 合并 付款 3件 以上 就 可以 8折 对 吧	我 拍好 3件 了 ， 到 时 一起 付款 就 自动 8折 了 ， 是 吗	3件 8折 是 在 139 的 基础 上 吗
这个 是 用 自来水 还是 纯净水	亲 ， 这款 宝贝 用 自来水 还是 饮水机 的 水	用 什么 水 比较 好 啊
想要 年龄 段长 1点 的	想 买到 12岁 的	想买 可以 用 的 久 1点 的
糖尿病 可以 吃 吗	糖尿 病人 可以 服用 吗
118 的 图片 可以 发给 我 看 一下 嘛	118l 双门 多大	118 的 尺寸 多大	428 的 有 多 高	118 的 图片 发 我 看 一下	118 的 是 哪 一款
冷冻油 加多少	冷冻油 怎么 加
我 在 福州 什么 时候 到	有 急用 ， 可否 发达 达
商家 你好 ， 有事 想 问 一下	这款 可以 只 买 主机 吗	能 配 个 按钮 给 我 吗	也 没 一个 客服	想 问下 宿舍 里可 以 用 吗	补发 的 还是 次品	定时 开关 定 不了 时 ， 该 怎么办	上次 买 的 这款 电热毯 才 用 了 没多久	才 用 了 十天 就 开始 烧坏 了	烘干机 已收到 ， 怎么 里面 缺少 2 根 白色 固定	这样 可以 了 吗 还要 什么 手续 吗	你好 怎么 缺 一根 你们 发货 时候 不 检查 吗	你们 怎么 跟 处理 啊	我 12月 卖 的 取暖器 有 半边 不 热 了	怎么 有些 插座 带 不 起	我 是 换货 的 ， 客服 怎么 没反应 了	没有 不要 耽误 时间 哦	我 这个 电热毯 总是 提示 缺水 可是 里面 却是 满 的	4 根 管子 收到 了 ， 是 故意 这么 短 的 吗	你好 请问 烘干机 开关 有 得 配 么	寄出 来 了	是 这样 的 呀 ， 前段 时间 都 好的 ， 最近 不会 热 了	烘干器 没有 工作	我 买 的 荣事达 取暖器 的 管子 烧坏 了 ， 你们 那 有 卖 得 吗	我 用 了 一段 时间 后 发现 这个 挡风 ， 一半 热 的 ， 一半 冷 的	请问 你们 上次 跟 我 发 的 什么 机子 ， 旧的	就是 重新 发 底下 的 一对 支架 是 吧	1点 也 不管 用	回来 是 正常 的 ， 前天 不正常 了	在 你 这里 买 的 暖炉 用 几次 电 接触 不好	转账 了 吗	机器 出问题 了	烘干机 怎么 突然 定 不了 时间 了 ， 只能 开关	有 什么 影响	还 没用 两次 可不 能用 了	有 三根 管子 都 是 那种 问题 ， 有 折弯 的 痕迹	已经 签收 了	买 的 烘干机 加 拍 了 一根 管子	机器 开关 的 旋钮 裂开	还有 45 的 快递费	支撑 的 都 够 ， 就是 挂 衣服 那根 粗 的 差 一根	你好 ， 有 调控 开关 配件 吗	怎么 没有 回复 呀	图片 里面 ， 管子 和 白条 连接 间隙 太大	家里 刚 买 的 电热毯 不会 热 了	我 的 邮费 给 我	感觉 ， 有人 拆机 过	是 按照 原单 退回 的	昨晚 开 的 好好 的 ， 给 关了 ， 再 开 就 不行 了	我 想 问 一下 为什么 吹出来 的 风不 暖 是 什么 原因	干衣机 那个 开关	老板 不 知道 怎么 回事 不 发热	我 去年 买 的 这个	不锈钢 豪华 款 的 更 粗	干衣机 旋钮 裂开 ， 无法 使用 烘干机 了	已经 到 你们 那 了 ， 麻烦 更换 下	我 打开 快递 。 里面 的 塑料 袋子 都 是 被 拆过 的	这个 电热 ， 怎么 冷风 啊	没有 在 吹风 … … 就 一直 有 个 响	我 买 的 里面 的 小 风扇 没 装好	麻烦 看看 聊天 记录	我 今天 水 也 装 了 开 了 一个 小时 了 还是 1点 都 不 热	我 买 的 塔扇 怎么 不 吹 凉风 呢	我 都 不 知道 你们 怎么搞 的	你 看下 我 的 快递 是不是 掉 了	哈喽 ， 之前 买了 两台 烘干机 ， 有 一台 那个 出 风 是 冷风	取暖器 今天 打开 ， 很暗 ， 发热管 上 很多 黑 点点	快递 单号 准确 无误 ， 谢谢	亲 ， 记得 把 机子 和 布罩 发出 来 哦	多发 几个 旋钮 过来	寄 风扇 给 我 了 吗	请 帮 我 转下 售后 ， 谢谢	你 这个 只能 开关 ， 转 不在 定 时间 上去	能 给我发 两个 塑料 支架 来 吗 安装 的 时候 弄 破了	为什么 我 先 垫付 你们 寄来 为什么 要 我 先 垫付	应该 有 6 个 白条 啊	老板 ， 有 条 塑料 死 开 了	定时 [ n3 ] ， 运行 了 十几 分钟 停 了	手 放 上面 完全 感觉 不到 热风	我 查询 过 了 ， 退货 2号 已签收	过热 保护 设定 为 多少度	底下 有 个 滑轮 碎掉 的	上面 那根 发热管 帮 我 补 一根	5分 钟 自动 变 冷风	这款 干衣 器 可以 不要 电机 吗 ， 只要 架子 和 布	这个 拧 的 纽 掉 了	现在 刚 打开 组装 怎么 有 烧 过 的 痕迹	可以 打 个 会员 折 吗	亲 ， 麻烦 你 给 单号	麻烦 给 一下 快递单 好	起 火花 了	我 之前 在 你家 买 的 烘干机	运营 的 时候 突然 里面 起 火花	换新 的 是 整机 换 还是 只 换 叶片	给 你们 把 货 发回 来 了 . 两个 月 没 回信	你们 怎么 回 事情	空调扇 的 遥控 用 不了	怎么 外壳 容易 融化	卡卡 响 个 不停	你好 ， 钢管 怎么 一根 短 1点	请问 我 买了 这个 干嘛 查不到 快递 去向 的	频繁 吹冷风 而且 出现 了 不能 开机 的 问题	买 的 三台 里 有 一台 不能 用	快递 单号 发过来 了	你 加 电热毯 突然 不 热 了	请问 这 式 烘干机 衣服 干 了 ， 还 在 运行 能 关掉 吗	没人 说句话 吗	下面 四根 管子 很松 装上 一下 就 散 了	不是 说 要 寄 开关 给 我 吗	没有 热度	开到 ⑩ 档 也 不好 使	为什么 这 两个 轮子 一直 会 掉	烘干机 一般 几个 小时 会 自己 停 呢	亲 货 给我发 过来 了 没有	你们 家 有 卖 烘干机 开关 按钮 吗	紫色 带 毛巾架 的 不能 购买 吗	插上 电 按 了 没动静	好的 ， 宝贝 有 除 螨 杀菌 功能 吗	有 主机 单 出售 的 吗	去年 的 事情 了	请问 怎么 能 知道 水 褥子 缺 不 缺水 呢	我 不会 用 ， 我 开 了 一个 钟 风 是 冷 的 ， 衣服 也 不见 干	你好 ！ 发错 货 了 ！ 我 买 的 是 白色 遥控 款 ！ 你 发 了 手动 板	这个 现在 开 着 里面 冒 火星 怎么 回事	热风 变成 冷风 了	你 看见 没 开关 开在 摇头	你们 出厂 怎么 也 不检 查一下 吧	我 的 货 为啥 不是我 的 电话 名字	水暖 毯 可以 反 垫 的 吧	但是 就是 没 热风	吹 了 一个 小时 了 还是 冷风	这个 可以 用 变压器 使用 吗	有没有 什么 办法 固定 在 暖风	我 收到 的 为什么 不能 制热	烘干机 才 用 了 没多久 怎么 就 吹出来 的 风 都 是 冷风 呢	管子 都 有 折断 的 印 呢	扇页 打不开 不 吹 热风	已经 填好 了	总是 一下 就 停 未能 正常 使用 过 ， 不 知道 有 什么 用	已经 是 噪声 了	想想 换货 也 麻烦 ， 还是 按 你 说 的 ， 补偿 我 10元 吧	你好 ， 这个 电器 坏掉 了 ， 不 工作 了	这个 承重 30kg 是 什么 意思	我 的 下层 固定 脚架 配合 中管 很松	亲亲 ， 你 是 机器 回复 吗        	这个 是 我 给 你 发 过去 的 快递 单号 ， 今天 上午 发出 去 的 货	里面 灯管 不 红 的 啊	这个 干衣机 没有 触屏 操作 的 吗	亲 你们 家 的 是 怎么 回事	我 想 问 一下 ， 机械 款 的 按钮 破了 ， 能 配 吗	看不到 问题 吗 问 几遍 了 ， 不 打扰 了	怎么办 呢 年前 买 的	管子 太长	坏 的 寄出 来 了	我 昨天 晚上 拍 的	看看 是 什么 问题 呗 ！ 打不开 了 ！	这个 机器 的 开关 又 卖 的 吗	是 电源 一直 插 着 工作 到 衣服 干透 为止 么	去年 买 的 干衣机 为啥 才 12 个 月 就 不 发热 了 呢	亲 ， 取暖器 收到 没	发 的 配件 ， 瘪 了	怎么 只能 开和 关	[ n14 ] 发回 电机 的 单号	不好 意思 如果 烘干机 还 在 快递 点 那 你 去 拿 回来 吧	今天 才 把 电暖器 打开 试用 ， 发现 不 运转	我 12月 份 买 的 现在 是 冷风 怎么 回事	发成 这个 了	就是 这 东西 炸掉 了	还要 怎 说 吗 难道 你 没有 记录 吗	怎么 点击 没办法 反应	店家 ， 你 发 的 两根 管长 度 不够 长 啊	哈喽 这个 烘干机 我 需要 14 台	距离 上次 说 要 寄给 我 已经 一周 了 ， 到底 寄 了 吗	出 了 冷风 不能 哄 干衣 服	老板 哄 干 机 吹 不了 热风 了	你们 不 看 字	去年 12月 买 的 ， 现在 不 暧 ， 是 什么 原因	你 这个 1点 热乎 气 都 没有	亲 ， 这 杆子 跟 套子 不对 啊	搞 得 我 的 插板 烧掉 了	怎么 回事	修理费 20元	你好 ！ 昨晚 下班 很晚 ， 老公 在家 试 了 烘干机 ， 都 没有 温度	为什么 不理 人 了	请问 晚上 几点 下班 ， 因 在 外面 做事 不 方便 拍照	怎么 开 十几 分钟 停掉 了	主机 怎么 1点 风 都 没有	烘 机 的 定时 开关 又坏了	冒烟 是 怎么 回事	最近 有点 忙 没 时间 寄 不 寄 了 ， 拿 去 修修 算了	亲 ， 上次 我 买了 两台 烘干机	我 买 的 烘干机 ， 不能 自动 关了	昨天 刚 用 ， 把 插座 给 烧 了	控 干 机 那个 扭 开关 的 坏了 、 刚 使用 两次 、 是否 可以 发 一个	我 买了 ， 我 说 怎么 出 冷风 的	这 塑料 也 太差 了 ， 亲	房间 里面 没有 插座 可以 用 吗	为什么 这个 童锁 解不开	白色 的 杠子 能不能 买	那个 干衣机 的 布 都 不够 大 啊	这个 单管 是 什么 情况 呢	这 是 一个 旧的 吧	会生 绣 吗	什么 1点 热气 也 没有	快递单 发给 我 下 ， 谢谢	你好 ， 我 上次 买来 送 人 的 ， 他 现在 说 出来 没 暖风	你 看 上面 记录 哇	怎么 不 回 消息	你好 、 我 在 你家 买 的 烘干机 怎么 没 热风 出 呢	请问 这个 可以 配 吗	用 了 两次 后 烘干机 出 的 风 就是 凉风 了 的	有 一条 段 了	用来 给 小鸡 取暖 ， 可不 可以	现在 几点 啦	说 清楚 啊	哈喽 ， 之前 买了 两台 烘干机 ， 有 一台 那个 出 风 是 冷风	用 着 用 着 冒火 了	好 ， 帮忙 优先 下 哈	快递 公司 说 有 0件 响声	关键 用 了 好几个 月 都 这样	店家 我 的 烘干机 怎么 突然 定 不了 时间 了 ， 只能 开关	外 布 破了 ， 可以 只 拍 外 布 不	烘 一下 就 停下来	亲 ， 你家 的 干衣机 设定 时间 怎么 没法 自己 停 的	出 了 16 的 运费	那个 开关 太水 了 把	已经 超过 48小时 了	我 开 了 半个 小时 没有 什么 温度	这个 新 的 接缝处 就 接 的 不怎么 严实	这个 是 裂开 的	你 20号 就 已签收	下面 的 开关 为什么 要 按着 不放 才能 工作	亲 之前 在 你家 买了 这个 暖风机	怎么 联系 快递员	我 这个 都 寄给 你 一个 星期 了	能不能 好好 回复	我 对 你们 的 服务 真的 很 失望	我家 买 的 这个 暖风机 有 个 问题	这 里面 冒 火星 是 什么 情况	暖风机 刚 拿到 两天 ， 不会 工作 了	现在 扳 不动	老板 ， 开关 拧 滑 了 可以 配 嘛	不 制热 啊	我 这个 电热毯 总是 提示 缺水 可是 里面 却是 满 的	全 是 自动 回复 的 ， 晕	豪华版 的 有没有 可以 挂 毛巾 的	你 看看 记录	我 买 的 这个 暖气 开 的 时候 闪 火花	我 说 你 给 我 的 是 二手货 吧	已签收 ， 麻烦 帮忙 换 一台 。 谢谢	这个 外面 的 布料 太差 了	在 你家 买 的 烘干机 现在 不能 烘 衣服 了 ， 是 怎么 回事 呢	之前 换货 的 那个 不 热 了	是 这样 卡 在 里面 吗	能 配 个 好 点 的 ， 裂 了 用 不了	怎么 吹 不了 热风	电机 有的 卖 吗	而且 也 不 热	里面 实际 出风口 多大	要 达到 多少度 这个 取暖器 才 会 自动 停下来	已签收 了	怎么 到 武汉 去 了	暖风机 不 转	脚 断 了 3 个 ， 叫 我 这 轮子 怎么 装上去	你家 这 什么 东西 啊	你好 我 买 的 荣事达 烘干机 有 一个 伦 子 没 锣丝	我 用 这样 的 插座 安全 吗	您好 ， 我 的 暖风机 已收到 了 吧	取暖器 突然 停止 不 运作 怎么 回事 啊	摇头 角度 多少	换 个 新机 会不会 出现 相同 的 状况	这个 注水 处 打不开 啊	我 之前 买 的 烘干机 ， 今天 拿出 来用 ， 怎么 吹出来 的 冷风	请问 客服 在不	今天 风干机 突然 停止 工作 了
这个 要 自己 装 吗	要 组装 吗
能 少点 吗	可以 便宜 点儿 吗	有 优惠 吗	优惠 一些 吧	价格 有点 高	能不能 便宜点
学校 没有 热水 能用 冷水 吗	不是 温水 行 吗	那 这个 清水 可以 是 热水 吗	这个 能用 冷水 洗 吗	洗面 用 温水 还是 凉水 好
什么 是 双 牵	双 牵 是 什么
这款 配有 丝带 吗	这个 有 配套 雪糕盒 的 吗	带有 配件 吗	蛋糕 盒带 丝带 吗
为啥 这么晚 才 发 啊	为什么 发货 时间 那么 晚	发货 这么晚
以 换代 修	多长 时间 换新	几年 换新	多久 换新	可以 换新 吗	1年 换新 吗
可以 放 微波炉 加热 吗	不能 煮 / 可以 微波 加热 吗
可以 电子 档 发票 吗	金额 能 多 开点 吗	你们 家 可以 开发票 吗	可以 开发票 吗 亲	能开 发票 吗	可以 规定 发票 内容 吗	发票 内容 开 的 什么	之前的 订单 可以 开发票 吗	开 什么 发票	可以 开 电子 发票 么	是 电子 发票 吗	去年 的 还 可以 开发票 吗	我 开发票 需要 提供 什么	你们 家 能开 发票 吗	你们 的 发票 是 什么 的	开发票 吗	我 之前的 订单 可以 开发票 吗	你家 开 的 什么 发票	可以 开发票 的 吗	可以 开发票 吗	有 发票 吗	去年 买 的 可以 开发票 吗	之前的 可以 开 的 吗 之前 没有 开	开发票 需要 提供 什么	你们 家 开发票 吗	支持 开发票 吗
包裹 分开 送 的	一般 几天 可以 收到货	多久 可以 到	包邮 吗 免邮 吗	昨天 买 的 东西 今天 还 能到 吗	发 的 2 个 包裹 吗 发 了 几个 包	你们 实体店 在 哪	几天 能 收到货	几天 可以 到 呢	你们 实体店 在哪里	拍下 后 一般 多久 能 寄到	发 什么 快递
素 颜 霜 要 卸妆水 吗
你家 颈霜 没有 了	我 颈 纹 比较 深	有 颈霜 吗
你好 我 想 问 一下 这 仪器 不掉 漆 吧	这个 会 掉漆 吗	好多 人 说 这款 雅 萌 掉漆
128l 双门 多大	128 的 尺寸 多大	128 的 是 哪 一款	128 的 图片 可以 发给 我 看 一下 嘛	128 的 给 我 看 一下
好像 没法 申请 售后 退款 耶	我 申请 售后 不行 啊 ， 我 应该 怎么 操作 啊
戴森 吹风机 可以 注册 吗	你好 你们 的 产品 是不是 只要 有 序列号 能 注册 就 可以 保修	我 在 实体店 买 的 这个 算 注册 了 吗	专属 服务	您好 ， 请问 一下 店里 卖 的 吹风机 的 序列号 在 官 网上 能 注册	这个 我 年初 买 的 忘 了 注册 信息 怎么 还 能 注册	根本 无法 注册
我 想 知道 现在 拍 跟 3.7号 拍 有 什么 区别 吗	我 想 看看 ， 女王 节	咱们 家 3 8 有 啥 活动 呢	现在 买 是 享 38 吗	3月 8号	女神节 有 什么 活动	预售 是 什么 活动 啊	这个 和 之前 预购 的 礼品 一样 吗	三八节 没 优惠 吗	你好 咨询 一下 38 会 做活 吗	这款 预售 和 那款 直接 发货 的 有 什么 区别 呢	预售 和 现货 有 区别 吗	预订 的 和 直接 买 没 差别 啊	想 问下 预售 时 购买 和 现在 购买 有 什么 区别	这个 女王 节 有 活动 吗	38 有 什么 活动	3.8 节 当天 ， 赠品 会 比 现在 多 吗 亲	38 活动 什么 时候 开始	给我发 一个 女王 节 攻略	现在 下单 可以 享受 三八节 优惠 了 吗	这个 精华 现在 拍 是 享受 3.8 活动 哈 75 毫升 的 呢	3.8 妇女节 呢	38 有 什么 活动 吗	现在 下单 和 三八节 买 有 区别 吗	你们 现在 38 预售	现在 购买 跟 3.8 买 有 什么 区别 吗
多 了 一双 袜子	收到 了 一双 袜子	包裹 里面 怎么 还有 一双 袜子	多 收到 一双 袜子
这个 女神节 是 几号 开枪	22号 开始 是不是	22号 买 [ n4 ] 吗
请问 你们 送 的 水管 几米 的	线 子 多长	烤箱 的 线源 多长	您们 电视 的 电源线 有 多长	这款 水壶 ， 那个 插头线 有 多长 呢	这个 热水器 电源线 有 多长	麻烦 问 一下 这个 电源线 有 多长	插 电 的 线 有 多长	线 有 多长	电源线 多长	这款 电线 有 多长	这个 线 有 多长	键盘线 大概 多长 呢	这个 有 多长 呢	耳机线 大概 多长 呢	鼠标线 大概 多长 呢
999号	我 要 买 6 包	巴布豆 6 包	333号
我 的 车 可以 用 吗	我 的 车 合适 吗	我 的 车 可以 加 这个 吗
有没有 vivoy55a	有没有 vivoy55a 的
其他 蚊香液 是否 通用	智能 驱蚊器 其他 蚊香液 是否 通用
地址 给 我	如何 退货
可以 提交 代付 吗	能 朋友 代付 吗	能 让 好友 付钱 吗	怎么 代付	好友 代付
为什么 不能 代付	提交 没有 朋友 代付	不 支持 代付	为什么 不 可以 朋友 代付
呀 有 啥 神秘 惊喜	神秘 惊喜 是 什么	这个 现在 有 什么 惊喜 呀	咨询 客服 有 惊喜
亲 昨晚 还 可以 正常 打开 app , 早上 起来 就 这样 闪 退 了	打不开 软件	魅族 16x 系统 应用 闪 退 怎么 回事	所有 的 在 文件夹 里 的 app 都 打不开	魅族 16 手机 应用 闪 退 是 什么 回事	系统 应用 里 的 东西 都 打不开	魅族 16th 打开 app 为什么 会 闪 退	点 文件夹 就 返回 桌面 主 页面	我 的 手机 软件 点 了 会 闪 退 ， 需要 点 几 次才 可以 进	按 很多 程式 都 闪 退
138l 双门 多大	138l 双门 的 给 我 看 一下	138l 的 尺寸 多大	138 的 图片 可不 可以 发 我 看 一下	138 的 是 哪 一款
跟 微波炉 啥 区别 呀	烤箱 和 微波炉 原理 一样 哦	烤箱 和 微波炉 一体 的 吗	这个 烤箱 和 微波炉 一样 吗	买 这个 烤箱 能不能 当 微波炉 用 热 饭菜	我 想 问下 ， 我 买 那个 烤箱 有 微波炉 功能 吗	可以 当成 微波炉	这 是 微波炉 还是 烤箱
爱 长痘 ， 皮肤 暗 黄 用 哪个 组合	皮肤 干燥 ， 长痘 用 什么 好	要 什么 去痘 好的
会不会 摔 一次 就 碎 了	摔 一下 会 碎 吗	我 的 手机壳 掉 地上 就 摔 碎裂 了	这个 玻璃 的 会不会 一 摔 就 碎 了 啊	会 碎掉 吗	容易 碎 吗	掉 地上 就 会 碎 吗	你好 ， 这种 玻璃 手机壳 会不会 很 容易 就 裂开 破了 呀	能用 多久	掉 地上 会不会 碎	你好 ， 这个 手机壳 是 玻璃 的 么 ， 能不能 摔坏	这个 玻璃 是 防爆 的 吗	您好 ， 这个 是不是 一 摔 就 会 裂 的 那种	背板 玻璃 会 容易 碎 吗	玻璃 壳 会 容易 碎 吗	这个 玻璃 不会 碎 吗	玻璃 的 会不会 很 容易 摔 烂	玻璃 的 摔下来 会不会 碎	是不是 容易坏 啊	会 容易 摔碎 吗	后背 玻璃 的 会不会 碎	手机壳 硬 不 硬
素 颜 霜 怎么 还没 发货	素 颜 霜 到底 什么 时候 发货	素 颜 霜 发货 时间	素 颜 霜 怎么 还没有 发货 ， 到底 有没 有货	素 颜 霜 什么 时候 发货
有 什么 办法 可以 退回	我 不要了	能 退回 吗	产品 不要了 退回 吧	不要 发货	先 不发货
我 不要 刻字	怎么 选 不 刻字 的	能 不能不 刻字
