运费险 理赔	运费险 什么 时候 能 返 给 我
有 运费险 吗	运费险 什么 时候 能 返 给 我
这双 鞋 能 优惠 啊 ？	亲 尽量 给我发 一双 线头 少 的 鞋 哈 谢谢
收到 我 退货 了 吧	我 收到 你 衣服 有 坏 的 ， 己 经 发 了 退货 申请
你好 ， 我 想 申请 一下 换货	我 收到 你 衣服 有 坏 的 ， 己 经 发 了 退货 申请
我 有 一个 申请 退款	我 收到 你 衣服 有 坏 的 ， 己 经 发 了 退货 申请
亲 ， 我 已经 提交 换货 申请 了	我 收到 你 衣服 有 坏 的 ， 己 经 发 了 退货 申请
153元 怎么 买	请问 篮球裤 在 哪 买
实体店 有货 吗	网上 售卖 的 货 跟 实体店 一样 吗
门店 自提	这件 裤子 不 支持 门店 提货 对 吧 ？
有 门店 吗	这件 裤子 不 支持 门店 提货 对 吧 ？
鞋子 大了 ， 怎么 换 ？	裤子 大了
你好 ， 换货	换货 的 衣服 你们 收到 了 吗
钻毛 怎么办	那 怎么办
1 . 文胸 尺码	2 . 内裤 尺码
买 一 送 一	买 一 送 一 的话 付款 时 自动 跳出 高 价格 的 么
退货 快递 可以 发 申通 吗	只有 申通
带 腰带 吗	有 腰带 吗
穿 什么码	身高 173 , 体重 140 , 哪个码 合适
送 袋子 的 吧 ？	有 袋子 吗
随机 的 袜子 是 什么 颜色 的 ， 能 备注 吗 ？	随机 发 的 船袜 可以 选 颜色 吗 ？
可以 自选 颜色 吗 ？	随机 发 的 船袜 可以 选 颜色 吗 ？
如何 换货	申请 了 一个 换货
改下 直播 价	帮 我 改下 直播
这个 只有 黑色 了 吗	这款 黑色 也 能 反光 吗
买 2 送 1 退	你好 ， 我 这个 单 但是 好像 是 买 2 免 一 的 吧
您好 这条 裤子	这条 裤子 大学生 穿 可以 嘛
满 300 减 70	那个 满 300 减 100 的 券 怎么 抢
我 想 改个 订单	合并 订单
不包邮 吗	您好 ， 不包邮 吗
能 优惠 那	直播间 过来 没有 优惠 吗
送 袋子 的 吧 ？	您好 买 这个 衣服 会 送 袋子 吗
送 纸袋 吗 ？	您好 买 这个 衣服 会 送 袋子 吗
我 申请 了 退款	我 申请 退款 了 ， 麻烦 处理 一下
申请 退 运费	我 申请 退款 了 ， 麻烦 处理 一下
衣服 没 吊牌	吊牌 剪 了 可以 退 吗
这款 有 腰带 么	这个 含 腰带 吗
我 的 退货 入库 了 么	退货 的话
亲 ， 买 3件 送 眼镜 吗	必须 3 ⃣ ️ 件 才 送 墨镜 ？
还有 这件 衣服 吗	我 想 问 你 下 这件 衣服 还有 别的 尺码 吗
只有 白色 的	白色 的 没有 s 的 了
1件 不包邮 吗	不包邮 吗
只有 粉色 呀	亲 ， 有没有 粉色 的 了 啊
这双 鞋 能 优惠 啊 ？	您好 ！ 现在 下单 能 优惠 吗 ？ 还要 丅 恤 。
怎么 没有 腰带	可是 没有 腰带 耶
贵州 快递	亲 物流 快递 吧
快递 是 ？	亲 物流 快递 吧
湖北 快递	亲 物流 快递 吧
搭配 链接 有 吗	你 可以 把 所有 的 包包 的 链接 发给 我 吗
包邮 吗 ？	亲亲 可以 给 我 包邮 吗
