想 快一点 着急	包裹可以加急吗
快递 慢死 啦	包裹可以加急吗
尽快 点	包裹可以加急吗
怎么 还没 发到 我 这里	包裹可以加急吗
成都 当地 的 货 ， 就 这么 慢	包裹可以加急吗
在 洛阳 一天 了 ， 还没有 送到 孟津 啊 ？	包裹可以加急吗
你们 太慢	包裹可以加急吗
我 真的 很急	包裹可以加急吗
石家庄 发 唐县 这么 慢	包裹可以加急吗
不是 说 7号 到 吗	包裹可以加急吗
我 还没 拿到 快递 呢	包裹可以加急吗
为什么 我 还没有 收到 我 的 包裹	包裹可以加急吗
我 的 货 为什么 还 没到	包裹可以加急吗
今天 下午 务必 送到	包裹可以加急吗
526 买 的 到 现在 也 没到	包裹可以加急吗
为什么 要 延迟 啊	包裹可以加急吗
我 想要 快一点	包裹可以加急吗
上午 可以 取货 急	包裹可以加急吗
一直 一直 推迟	包裹可以加急吗
我 也是醉了 慢 的 要死	包裹可以加急吗
最好 8号 到	包裹可以加急吗
买了 快 一个 周 了	包裹可以加急吗
今天 不 派件 啊	包裹可以加急吗
5天 了 还 没到 一 半路 ， 怎么回事	包裹可以加急吗
包裹 一直 在 派送 中 怎么回事	包裹可以加急吗
到底 要 等 多久	包裹可以加急吗
可不可以 帮 我 催一下 呢	包裹可以加急吗
我 准备 去 上班 了 ， 如果 现在 不 配送 我 今天 拿 不到 快递	包裹可以加急吗
你们 是 真的 慢 到 要死	包裹可以加急吗
昨天 就 这样 显示 今天 还 没到	包裹可以加急吗
派件 小哥 这么 慢	包裹可以加急吗
我 的 收件人 手机号 填写 错误 ， 现在 收不到 取货码	没有收到取件码怎么办
怎么 还没有 收到 收货 码 呢 ？	没有收到取件码怎么办
取件码 忘 了	没有收到取件码怎么办
收件 码 为什么 还没 发	没有收到取件码怎么办
到 现在 还没 有人 通知 我 取	没有收到取件码怎么办
最起码 得 发 个 短信 通知 一下	没有收到取件码怎么办
我 的 包裹 送 哪儿 了 为什么 没有 给我发 取件码	没有收到取件码怎么办
自提 会 有 通知 吗	没有收到取件码怎么办
没有 发 二维码	没有收到取件码怎么办
取货码 没有	没有收到取件码怎么办
手机 停机 了 收不到 验证 吗 怎么办	没有收到取件码怎么办
村 服务站 没有 通知	没有收到取件码怎么办
如何 获得 取件码	没有收到取件码怎么办
这个 件 的 取件码 错误 了 投递员 电话 不通 啊	没有收到取件码怎么办
我 取 快件 的 时候 箱子 又 自动 关闭 打不开 了 可不可以 从新发 个 验证码	没有收到取件码怎么办
取件码 被 误删 了	没有收到取件码怎么办
没有 发送 取货 号 啊	没有收到取件码怎么办
没 信息 通知 我	没有收到取件码怎么办
为什么 没有 取件码	没有收到取件码怎么办
查 取件码	没有收到取件码怎么办
货到 却 未 发短信 通知	没有收到取件码怎么办
快递 到 了 一天 却 不 发 信息 给 本人	没有收到取件码怎么办
取件码 有 什么 用	没有收到取件码怎么办
没有 发 取件码	没有收到取件码怎么办
早上 10:00 多 的 邮包 到 了 ， 但 现在 还 没给 我们 发 取件 消息	没有收到取件码怎么办
丰 巢 的 编码 没有 收到	没有收到取件码怎么办
我 的 提货 码 怎么 没有	没有收到取件码怎么办
咋 不来 信息	没有收到取件码怎么办
取件码 是 短信 收到 还是 从 物流信息 上 查到 以后 就 可以 去 取件 了	没有收到取件码怎么办
短信 通知	没有收到取件码怎么办
你好 取件 吗 是	没有收到取件码怎么办
快递 显示 已经 放到 快递 柜 ， 但是 没有 收到 取件码	没有收到取件码怎么办
没有 收货 码	没有收到取件码怎么办
我 昨天 的 快递 是 已经 到 了 ， 我们 村 那边 可是 我 没有 收到 短信 ， 怎么回事	没有收到取件码怎么办
我 的 包裹 给 我 运 丢了 ， 怎么办 ？ ？ ？ ？	包裹丢失或找不到包裹怎么办
不会 是 丢了 吧	包裹丢失或找不到包裹怎么办
快递 里面 的 东西 被 调换 了	包裹丢失或找不到包裹怎么办
货 没收到 给 弄 丢了	包裹丢失或找不到包裹怎么办
找不到	包裹丢失或找不到包裹怎么办
快递 丢件 怎么办	包裹丢失或找不到包裹怎么办
我 的 小米 钢化 膜 都 没收到 ， 给 他们 丢了	包裹丢失或找不到包裹怎么办
这个 快递 不是我 的	包裹丢失或找不到包裹怎么办
快递 为啥 别人 给 取 了	包裹丢失或找不到包裹怎么办
空包 怎么 证明	包裹丢失或找不到包裹怎么办
我 如何 找到 我 的 物品	包裹丢失或找不到包裹怎么办
被 人 拿走 了	包裹丢失或找不到包裹怎么办
我 有 东西 遗落 了	包裹丢失或找不到包裹怎么办
丢失 索赔	包裹丢失或找不到包裹怎么办
门卫 处 没有 包裹	包裹丢失或找不到包裹怎么办
我 的 快递 走 丢了	包裹丢失或找不到包裹怎么办
快递 没 领到 怎么办	包裹丢失或找不到包裹怎么办
能否 给 个 包装袋	UNKNOWN
可以 送货 的 时候 把 东西 放在 蜂巢 快递 柜 吗	UNKNOWN
请问 韩国 有 圆通速递 吗 ？	UNKNOWN
你好 ， 我 的 快递 写 的 很 清楚 ， 拒收 快递 柜	UNKNOWN
怎么 会 有 2kg 重	UNKNOWN
可以 帮 我 放 丰 巢 吗	UNKNOWN
快递员 上门 会 否 带 包装袋	UNKNOWN
如何 寄回 台湾	UNKNOWN
可以 让 它 换 空运 吗 ？	UNKNOWN
你们 上门取件 时 能否 提供 外包装 ？	UNKNOWN
电子 发票	UNKNOWN
有 2 1000克	UNKNOWN
你们 上门 寄件 能带 个 袋子 吗	UNKNOWN
不要 放 快递 柜 ！ ！ ！ ！	UNKNOWN
麻烦 不要 放进 快递 柜	UNKNOWN
直接 返 我 的 运费险 就 行	UNKNOWN
还有 请 按 地址 要求 派送 不要 放到 丰 巢 柜	UNKNOWN
有 发票 吗	UNKNOWN
